Alisha Perkins	@runlikeam0ther	Wife to @glen_perkins
Ron Gardenhire	@Ron35Gardenhire	Minnesota Twins Manager
Bert Blyleven	@CircleMeBertHOF	Minnesota Twins Announcer
Minnesota Twins Tickets	@MNTwinsTickets	Minnesota Twins Tickets
Twins Dugout	@twinsdugout	Twins Dugout
Justin Morneau News	@JMorneau_News	Justin Morneau News
Minnesota Twins Buzz	@twinsbuzztap	Minnesota Twins Buzz
Twins Daily	@TwinsDaily	Twins Daily
Joe Nathan	@JoeNathan36	Player
Drew Butera	@drewbutera	Player
Minnesota Twins	@Twins	Minnesota Twins Official 
Dave St. Peter	@TwinsPrez	Twins President
Michael Cuddyer	@mcuddy3	Former Player
Rene Tosoni	@Tosoni08	Player
Dustin Morse	@Twins_morsecode	Communications
Minnesota Twins Community Blog	@twinsblogger	Minnesota Twins Community Blog
TC Bear	@TC_00	TC Bear
Scott Diamond	@Scott_Diamond58	Player
Twins Ground Crew	@TCGroundCrew	Twins Ground Crew
Mike Herman	@HermPR	Director of Baseball Communications
Robby Incmikoski	@robbyfsn	Fox Sports Reporter
Cory Provus	@CoryProvus	Play-by-Play Broadcaster
Scout Twins	@ScoutTwins	Twins Minor League and Recruiting News
Minnesota Twins Weather	@TwinsWeather	Minnesota Twins Weather
Rochester Red Wings	@RochRedWings	Rochester Red Wings